-15
31
-17
19
00000000000000000000000000000000000000000000000
11111111111111111111111111111111111111111111110
10000000000000000000000000000000000000000000010
10000000000000000000000000000000000000000000010
10000000000000000000000000000000000000000000010
10000000000000000000000000000000000000000000010
10000000000000000000000000000000000000000000010
10000000000000000000000000000000000000000000010
10000000000000000000000000000000000000000000010
10000000000000000000000001000000000000000000010
10000000001111111000000001110000000000000000010
10000000001000001000000000010000000000000000010
10000000001000001000000000010000000000000000010
10000000001000001000000000010000000000000000010
10000000001000001000000000010000000000000000010
10000000001000001000000000010000000000000000010
10000000001111111000000000010000000000000000010
10000000000000110000000000010000000000000000010
10000000000000000000000000010000000000000000010
10000000000000000000000000000000000000000000010
10000000001111111000000000110000000000000000010
10000000001111111000000001100000000000000000010
10000000001111111000000011000000000000000000010
10000000001111111000000110000000000000000000010
10000000001111111000001100000000000000000000010
10000000001111111000011000000000000000000000010
10000001101111111000110000000000000000000000010
10000001100000000000100000000000000000000000010
10000000000000000000100000000000000000000000010
10000000000000000000111100000000000000000000010
10000000000000000000000100000000000000000000010
10000000000000000000000100000000000000000000010
10000000000000000000000100000000000000000000010
10000000000000000000000100000000000000000000010
10000000000000000000001110000000000000000000010
10000000000000000000001110000000000000000000010
11111111111111111111111111111111111111111111110
