-8
13
-16
11
0000000000000000000000
0000000000000000001000
0001111111000000001110
0001000001000000000010
0001000001000000000010
0001000001000000000010
0001000001000000000010
0001000001000000000010
0001111111000000000010
0000000110000000000010
0000000000000000000010
0000000000000000000000
0001111111000000000110
0001111111000000001100
0001111111000000011000
0001111111000000110000
0001111111000001100000
0001111111000011000000
1101111111000110000000
1100000000000100000000
0000000000000100000000
0000000000000111100000
0000000000000000100000
0000000000000000100000
0000000000000000100000
0000000000000000100000
0000000000000001110000
0000000000000001110000
